NO textures/wall_1.xpm
SO textures/wall_2.xpm
WE textures/wall_3.xpm
EA textures/wall_4.xpm
C 204,204,255
F 102,102,30



111111111111111111111111
100000000000000000000001
100000000000000000000001
100000000000100000000001
100E00000001000000000001
100000000000000000000001
100000000000000000000001
111111111111111111111111
