NO textures/wall_1.xpm
SO textures/wall_2.xpm
WE textures/wall_3.xpm
EA textures/wall_4.xpm
C 51,192,227
F 18,113,39



         11111111  111111111111111111
         111111111  100000000000000001
        1111111111110110000111100000001111111111
11111111110000000000000001111111111111
1111111111000000S000000000111
10000000000000000000000111111
1000000011110000000000001001
10000000101001101011100000001
10000000111110000001 10100001
11111111111111111111 11111111
     
1111 111111111111111111111111
1111 100000000000000000000001
1111 111111111111111111111111

