NO textures/wall_1.xpm
SO textures/wall_2.xpm
WE textures/wall_3.xpm
EA textures/wall_4.xpm

F 18,113,39
C 51,192,227


         1111N1111  111111111111111111
         100000001  100000000000000001
         10110000111100000001111111111
11111111110000000000000000011111
10000000111100010000000001001
100000001  100110101110000001
10000000111110000001 10100001
11111111111111111111 11111111
     
1111 111111111111111111111111
1111 1000000cococococ00000001
1111 111111111111111111111111
